fe fe fe fe fe fe fe fe fe fe fe fe fe fe fe fe fe fe fe fe fe fe fe fe fe
fe gr gr gr gr gr gr gr gr gr gr gr gr gr gr gr gr fe fe fe fe fe fe fe fe
fe gr fe fe fe fe fe fe fe fe fe fe fe fe fe fe gr gr gr gr gr gr gr fe fe
fe gr fe fe fe fe fe fe fe fe fe fe fe fe fe fe gr fe fe fe fe fe gr fe fe
fe gr fe fe fe gr gr gr fe fe fe fe fe fe fe fe gr fe fe fe fe fe gr fe fe
fe gr gr gr gr gr gr gr fe fe fe fe fe fe fe fe wa wa fe fe fe fe gr fe fe
fe gr fe fe fe gr gr gr fe fe fe fe fe fe fe wa wa wa wa fe fe fe gr fe fe
fe gr fe fe fe fe fe fe fe fe fe fe fe fe wa wa wa wa wa wa fe fe gr fe fe
fe gr fe fe fe fe fe fe fe fe fe fe fe fe wa wa wa wa wa wa fe fe gr fe fe
fe gr fe fe fe fe fe fe fe fe fe fe fe fe fe wa wa wa wa fe fe fe gr fe fe
fe gr fe fe fe fe fe fe fe fe fe fe fe fe fe fe wa wa fe fe fe fe gr fe fe
fe gr gr fe gr gr gr gr gr fe fe fe fe fe fe fe gr fe fe fe fe fe gr fe fe
fe fe gr fe gr gr gr gr gr fe fe fe fe fe fe fe gr fe fe fe fe fe gr fe fe
fe fe gr gr gr gr gr gr gr gr gr gr gr gr gr gr gr fe fe fe fe fe gr fe fe
fe fe fe fe gr gr gr gr gr fe fe fe fe fe fe fe fe fe fe fe fe fe gr fe fe
fe fe fe fe gr gr gr gr gr fe fe fe fe fe fe fe fe fe fe fe fe fe gr fe fe
fe fe fe fe fe fe gr fe fe fe fe fe fe fe fe fe fe fe fe fe fe fe gr fe fe
fe fe fe fe fe fe gr fe fe fe fe fe fe fe fe fe fe fe fe fe fe fe gr fe fe
fe fe fe fe fe fe gr fe fe fe fe fe fe fe fe fe fe fe fe fe fe fe gr fe fe
fe fe fe fe fe fe gr fe fe fe fe fe fe fe fe fe fe fe fe fe fe fe gr fe fe
fe fe fe fe fe fe gr fe fe fe fe fe fe fe fe fe fe fe fe fe fe fe gr fe fe
fe fe fe fe fe fe gr fe fe fe fe fe fe fe fe fe fe fe fe fe fe gr gr gr fe
fe fe fe fe fe fe gr gr gr gr gr gr gr gr gr gr gr gr gr gr gr gr gr gr fe
fe fe fe fe fe fe fe fe fe fe fe fe fe fe fe fe fe fe fe fe fe gr gr gr fe
fe fe fe fe fe fe fe fe fe fe fe fe fe fe fe fe fe fe fe fe fe fe fe fe fe