gr gr gr gr gr gr gr gr gr gr gr gr gr gr gr gr gr gr gr gr gr gr gr gr gr gr gr gr gr gr gr gr gr gr gr gr gr gr gr gr gr gr gr gr gr gr gr wa wa wa
gr gr gr gr gr gr gr gr gr gr gr gr gr gr gr gr gr gr gr gr gr gr gr gr gr gr gr gr gr gr gr gr gr gr gr gr gr gr gr gr gr gr gr gr gr gr wa wa wa wa
gr gr gr gr gr gr gr gr gr gr gr gr gr gr gr gr gr gr gr gr gr gr gr gr gr gr gr gr gr gr gr gr gr gr gr gr gr gr gr gr gr gr gr gr gr wa wa wa wa wa
gr gr gr gr gr gr gr gr gr gr gr gr gr gr gr gr gr gr gr gr gr gr gr gr gr gr gr gr gr gr gr gr gr gr gr gr gr gr gr gr gr gr gr gr wa wa wa wa wa wa
gr gr gr gr gr gr gr gr gr gr gr gr gr gr gr gr gr gr gr gr gr gr gr gr gr gr gr gr gr gr gr gr gr gr gr gr gr gr gr gr gr gr wa wa wa wa wa wa wa gr
gr gr gr gr gr gr gr gr gr gr gr gr gr gr gr gr wa wa gr gr gr gr gr gr gr gr gr gr gr gr gr gr gr gr gr gr gr gr gr gr gr wa wa wa wa wa wa wa gr gr
gr gr gr gr gr gr gr gr gr gr gr gr gr gr gr wa wa wa wa gr gr gr gr gr gr gr gr gr gr gr gr gr gr gr gr gr gr gr gr gr wa wa wa wa wa wa wa gr gr gr
gr gr gr gr gr gr gr gr gr gr gr gr gr gr wa wa wa wa wa wa gr gr gr gr gr gr gr gr gr gr gr gr gr gr gr gr gr gr gr wa wa wa wa wa wa gr gr gr gr gr
gr gr gr gr gr gr gr gr gr gr gr gr gr gr wa wa wa wa wa wa gr gr gr gr gr gr gr gr gr gr gr gr gr gr gr gr gr gr gr wa wa wa wa wa gr gr gr gr gr gr
gr gr gr gr gr gr gr gr gr gr gr gr gr gr gr wa wa wa wa gr gr gr gr gr gr gr gr gr gr gr gr gr gr gr gr gr gr gr wa wa wa wa wa gr gr gr gr gr gr gr
gr gr gr gr gr gr gr gr gr gr gr gr gr gr gr gr wa wa gr gr gr gr gr gr gr gr gr gr gr gr gr gr gr gr gr gr gr gr wa wa wa wa wa gr gr gr gr gr gr gr
gr gr gr gr gr gr gr gr gr gr gr gr gr gr gr gr gr gr gr gr gr gr gr gr gr gr gr gr gr gr gr gr gr gr gr gr gr wa wa wa wa wa wa gr gr gr gr gr gr gr
gr gr gr gr gr gr gr gr gr gr gr gr gr gr gr gr gr gr gr gr gr gr gr gr gr gr gr gr gr gr gr gr gr gr gr gr gr wa wa wa wa wa gr gr gr gr gr gr gr gr
gr gr gr gr gr gr gr gr gr gr gr gr gr gr gr gr gr gr gr gr gr gr gr gr gr gr gr gr gr gr gr gr gr gr gr gr gr wa wa wa wa wa gr gr gr gr gr gr gr gr
gr gr gr gr gr gr gr gr gr gr gr gr gr gr gr gr gr gr gr gr gr gr gr gr gr gr gr gr gr gr gr gr gr gr gr gr wa wa wa wa wa wa gr gr gr gr gr gr gr gr
gr gr gr gr gr gr gr gr gr gr gr gr gr gr gr gr gr gr gr gr gr gr gr gr gr gr gr gr gr gr gr gr gr gr gr gr wa wa wa wa wa wa gr gr gr gr gr gr gr gr
gr gr gr gr gr gr gr gr gr gr gr gr gr gr gr gr gr gr gr gr gr gr gr gr gr gr gr gr gr gr gr gr gr gr gr gr wa wa wa wa wa wa gr gr gr gr gr gr gr gr
gr gr gr gr gr gr gr gr gr gr gr gr gr gr gr gr gr gr gr gr gr gr gr gr gr gr gr gr gr gr gr gr gr gr gr gr wa wa wa wa wa wa gr gr gr gr gr gr gr gr
gr gr gr gr gr gr gr gr gr gr gr gr gr gr gr gr gr gr gr gr gr gr gr gr gr gr gr gr gr gr gr gr gr gr gr gr wa wa wa wa wa wa wa gr gr gr gr gr gr gr
gr gr gr gr gr gr gr gr gr gr gr gr gr gr gr gr gr gr gr gr gr gr gr gr gr gr gr gr gr gr gr gr gr gr gr gr gr wa wa wa wa wa wa gr gr gr gr gr gr gr
gr gr gr gr gr gr gr gr gr gr gr gr gr gr gr gr gr gr gr gr gr gr gr gr gr gr gr gr gr gr gr gr gr gr gr gr gr wa wa wa wa wa wa wa gr gr gr gr gr gr
gr gr gr gr gr gr gr gr gr gr gr gr gr gr gr gr gr gr gr gr gr gr gr gr gr gr gr gr gr gr gr gr gr gr gr gr gr wa wa wa wa wa wa wa gr gr gr gr gr gr
gr gr gr gr gr gr gr gr gr gr gr gr gr gr gr gr gr gr gr gr gr gr gr gr gr gr gr gr gr gr gr gr gr gr gr gr gr gr wa wa wa wa wa wa gr gr gr gr gr gr
gr gr gr gr gr gr gr gr gr gr gr gr gr gr gr gr gr gr gr gr gr gr gr gr gr gr gr gr gr gr gr gr gr gr gr gr gr gr wa wa wa wa wa wa wa gr gr gr wa wa
gr gr gr gr gr gr gr gr gr gr gr gr gr gr gr gr gr gr gr gr gr gr gr gr gr gr gr gr gr gr gr gr gr gr gr gr gr gr gr wa wa wa wa wa wa wa wa wa wa wa
gr gr gr gr gr gr gr gr gr gr gr gr gr gr gr gr gr gr gr gr gr gr gr gr gr gr gr gr gr gr gr gr gr gr gr gr gr gr gr gr wa wa wa wa wa wa wa wa wa wa
gr gr gr gr gr gr gr gr gr gr gr gr gr gr gr gr gr gr gr gr gr gr gr gr gr gr gr gr gr gr gr gr gr gr gr gr gr gr gr gr gr gr wa wa wa wa wa wa wa wa
gr gr gr gr gr gr gr gr gr gr gr gr gr gr gr gr gr gr gr gr gr gr gr gr gr gr gr gr gr gr gr gr gr gr gr gr gr gr gr gr gr gr gr wa wa wa wa wa wa wa
gr gr gr gr gr gr gr gr gr gr gr gr gr gr gr gr gr gr gr gr gr gr gr gr gr gr gr gr gr gr gr gr gr gr gr gr gr gr gr gr gr gr gr gr gr gr gr gr gr gr
gr gr gr gr gr gr gr gr gr gr gr gr gr gr gr gr gr gr gr gr gr gr gr gr gr gr gr gr gr gr gr gr gr gr gr gr gr gr gr gr gr gr gr gr gr gr gr gr gr gr
gr gr gr gr gr gr gr gr gr gr gr gr gr gr gr gr gr gr gr gr gr gr gr gr gr gr gr gr gr gr gr gr gr gr gr gr gr gr gr gr gr gr gr gr gr gr gr gr gr gr
gr gr gr gr gr gr gr gr gr gr gr gr gr gr gr gr gr gr gr gr gr gr gr gr gr gr gr gr gr gr gr gr gr gr gr gr gr gr gr gr gr gr gr gr gr gr gr gr gr gr
gr gr gr gr gr gr gr gr gr gr gr gr gr gr gr gr gr gr gr gr gr gr gr gr gr gr gr gr gr gr gr gr gr gr gr gr gr gr gr gr gr gr gr gr gr gr gr gr gr gr
gr gr gr gr gr gr gr gr gr gr gr gr gr gr gr gr gr gr gr gr gr gr gr gr gr gr gr gr gr gr gr gr gr gr gr gr gr gr gr gr gr gr gr gr gr gr gr gr gr gr
gr gr gr gr gr gr gr gr gr gr gr gr gr gr gr gr gr gr gr gr gr gr gr gr gr gr gr gr gr gr gr gr gr gr gr gr gr gr gr gr gr gr gr gr gr gr gr gr gr gr
gr gr gr gr gr gr gr gr gr gr gr gr gr gr gr gr gr gr gr gr gr gr gr gr gr gr gr gr gr gr gr gr gr gr gr gr gr gr gr gr gr gr gr gr gr gr gr gr gr gr
gr gr gr gr gr gr gr gr gr gr gr gr gr gr gr gr gr gr gr gr gr gr gr gr gr gr gr gr gr gr gr gr gr gr gr gr gr gr gr gr gr gr gr gr gr gr gr gr gr gr
gr gr gr gr gr gr gr gr gr gr gr gr gr gr gr gr gr gr gr gr gr gr gr gr gr gr gr gr gr gr gr gr gr gr gr gr gr gr gr gr gr gr gr gr gr gr gr gr gr gr
gr gr gr gr gr gr gr gr gr gr gr gr gr gr gr gr gr gr gr gr gr gr gr gr gr gr gr gr gr gr gr gr gr gr gr gr gr gr gr gr gr gr gr gr gr gr gr gr gr gr
gr gr gr gr gr gr gr gr gr gr gr gr gr gr gr gr gr gr gr gr gr gr gr gr gr gr gr gr gr gr gr gr gr gr gr gr gr gr gr gr gr gr gr gr gr gr gr gr gr gr
gr gr gr gr gr gr gr gr gr gr gr gr gr gr gr gr gr gr gr gr gr gr gr gr gr gr gr gr gr gr gr gr gr gr gr gr gr gr gr gr gr gr gr gr gr gr gr gr gr gr
gr gr gr gr gr gr gr gr gr gr gr gr gr gr gr gr gr gr gr gr gr gr gr gr gr gr gr gr gr gr gr gr gr gr gr gr gr gr gr gr gr gr gr gr gr gr gr gr gr gr
gr gr gr gr gr gr gr gr gr gr gr gr gr gr gr gr gr gr gr gr gr gr gr gr gr gr gr gr gr gr gr gr gr gr gr gr gr gr gr gr gr gr gr gr gr gr gr gr gr gr
gr gr gr gr gr gr gr gr gr gr gr gr gr gr gr gr gr gr gr gr gr gr gr gr gr gr gr gr gr gr gr gr gr gr gr gr gr gr gr gr gr gr gr gr gr gr gr gr gr gr
gr gr gr gr gr gr gr gr gr gr gr gr gr gr gr gr gr gr gr gr gr gr gr gr gr gr gr gr gr gr gr gr gr gr gr gr gr gr gr gr gr gr gr gr gr gr gr gr gr gr
gr gr gr gr gr gr gr gr gr gr gr gr gr gr gr gr gr gr gr gr gr gr gr gr gr gr gr gr gr gr gr gr gr gr gr gr gr gr gr gr gr gr gr gr gr gr gr gr gr gr
gr gr gr gr gr gr gr gr gr gr gr gr gr gr gr gr gr gr gr gr gr gr gr gr gr gr gr gr gr gr gr gr gr gr gr gr gr gr gr gr gr gr gr gr gr gr gr gr gr gr
gr gr gr gr gr gr gr gr gr gr gr gr gr gr gr gr gr gr gr gr gr gr gr gr gr gr gr gr gr gr gr gr gr gr gr gr gr gr gr gr gr gr gr gr gr gr gr gr gr gr
gr gr gr gr gr gr gr gr gr gr gr gr gr gr gr gr gr gr gr gr gr gr gr gr gr gr gr gr gr gr gr gr gr gr gr gr gr gr gr gr gr gr gr gr gr gr gr gr gr gr
gr gr gr gr gr gr gr gr gr gr gr gr gr gr gr gr gr gr gr gr gr gr gr gr gr gr gr gr gr gr gr gr gr gr gr gr gr gr gr gr gr gr gr gr gr gr gr gr gr gr