fe fe fe fe fe fe fe fe fe fe fe fe fe fe fe fe fe fe fe fe fe fe fe fe fe
fe gr gr gr gr gr gr gr gr gr gr gr gr gr gr gr gr gr gr gr gr gr gr gr fe
fe gr gr gr gr gr gr gr gr gr gr gr gr gr gr gr gr gr gr gr gr gr gr gr fe
fe fe fe fe gr gr gr gr gr gr gr gr gr gr gr gr gr gr gr gr gr gr gr gr fe
fe gr gr gr gr fe gr gr gr gr gr gr gr gr gr gr gr gr gr gr gr gr gr gr fe
fe gr fe fe fe fe gr gr gr gr gr gr gr gr gr gr wa wa gr gr gr gr gr gr fe
fe gr gr gr gr gr gr gr gr gr gr gr gr gr gr wa wa wa wa gr gr gr gr gr fe
fe gr fe fe fe gr gr gr gr gr gr gr gr gr wa wa wa wa wa wa gr gr gr gr fe
fe gr gr gr gr gr gr gr gr gr gr gr gr gr wa wa wa wa wa wa gr gr gr gr fe
fe gr gr gr gr gr gr gr gr gr gr gr gr gr gr wa wa wa wa gr gr gr gr gr fe
fe gr gr gr gr gr gr gr gr gr gr gr gr gr gr gr wa wa gr gr gr gr gr gr fe
fe gr gr gr gr gr gr gr gr gr gr gr gr gr gr gr gr gr gr gr gr gr gr gr fe
fe gr gr gr gr gr gr gr gr gr gr gr gr gr gr gr gr gr gr gr gr gr gr gr fe
fe gr gr gr gr gr gr gr gr gr gr gr gr gr gr gr gr gr gr gr gr gr gr gr fe
fe gr gr gr gr gr gr gr gr gr gr gr gr gr gr gr gr gr gr gr gr gr gr gr fe
fe gr gr gr gr gr gr gr gr gr gr gr gr gr gr gr gr gr gr gr gr gr gr gr fe
fe gr gr gr gr gr gr gr gr gr gr gr gr gr gr gr gr gr gr gr gr gr gr gr fe
fe gr gr gr gr gr gr gr gr gr gr gr gr gr gr gr gr gr gr gr gr gr gr gr fe
fe gr gr gr gr gr gr gr gr gr gr gr gr gr gr gr gr gr gr gr gr gr gr gr fe
fe gr gr gr gr gr gr gr gr gr gr gr gr gr gr gr gr gr gr gr gr gr gr gr fe
fe gr gr gr gr gr gr gr gr gr gr gr gr gr gr gr gr gr gr gr gr gr gr gr fe
fe gr gr gr gr gr gr gr gr gr gr gr gr gr gr gr gr gr gr gr gr gr gr gr fe
fe gr gr gr gr gr gr gr gr gr gr gr gr gr gr gr gr gr gr gr gr gr gr gr fe
fe gr gr gr gr gr gr gr gr gr gr gr gr gr gr gr gr gr gr gr gr gr gr gr fe
fe fe fe fe fe fe fe fe fe fe fe fe fe fe fe fe fe fe fe fe fe fe fe fe fe